"a" = (/turf/open/floor/plating/asteroid/basalt/lava_land_surface,/area/lavaland/surface/outdoors)
"b" = (/obj/effect/forcefield/summoning,/turf/open/floor/plating/asteroid/basalt/lava_land_surface,/area/ruin/unpowered/ritual_site_shield)
"d" = (/turf/template_noop,/area/template_noop)
"e" = (/turf/open/floor/plating/asteroid/basalt/lava_land_surface,/area/ruin/unpowered/ritual_site)
"f" = (/mob/living/simple_animal/hostile/megafauna/cultist/blue,/turf/open/floor/plating/asteroid/basalt/lava_land_surface,/area/ruin/unpowered/ritual_site)
"g" = (/mob/living/simple_animal/hostile/megafauna/cultist/black,/turf/open/floor/plating/asteroid/basalt/lava_land_surface,/area/ruin/unpowered/ritual_site)
"h" = (/obj/effect/gibspawner/human,/turf/open/floor/plating/asteroid/basalt/lava_land_surface,/area/ruin/unpowered/ritual_site)
"i" = (/obj/effect/forcefield/summoning,/turf/open/floor/plating/asteroid/basalt/lava_land_surface,/area/ruin/unpowered/ritual_site)
"j" = (/mob/living/simple_animal/hostile/megafauna/cultist/red,/turf/open/floor/plating/asteroid/basalt/lava_land_surface,/area/ruin/unpowered/ritual_site)
"k" = (/mob/living/simple_animal/hostile/megafauna/cultist/white,/turf/open/floor/plating/asteroid/basalt/lava_land_surface,/area/ruin/unpowered/ritual_site)
"l" = (/mob/living/simple_animal/hostile/megafauna/cultist/yellow,/turf/open/floor/plating/asteroid/basalt/lava_land_surface,/area/ruin/unpowered/ritual_site)
"m" = (/obj/effect/summoning_rune,/turf/open/floor/plating/asteroid/basalt/lava_land_surface,/area/ruin/unpowered/ritual_site)
"n" = (/obj/effect/landmark/portal_exit{id = "ritual enter"},/turf/open/floor/plating/asteroid/basalt/lava_land_surface,/area/ruin/unpowered/ritual_site)
"o" = (/obj/item/clothing/head/helmet/skull,/turf/open/floor/plating/asteroid/basalt/lava_land_surface,/area/ruin/unpowered/ritual_site)
"p" = (/obj/effect/portal/permanent/one_way/one_use/nether{id = "ritual enter"},/turf/open/floor/plating/asteroid/basalt/lava_land_surface,/area/lavaland/surface/outdoors)

(1,1,1) = {"
ddddddddddddddddddddddddddddddddddd
ddddddddddddddddddddddddddddddddddd
ddddddddaaaaaaaaaaaaaaaaaaadddddddd
dddddddaaaaaaaaaaaaaaaaaaaaaddddddd
ddddddaaabbbbbbbbbbbbbbbbbaaadddddd
dddddaaabbbbbbbbbbbbbbbbbbbaaaddddd
ddddaaabbbbbbbbbbbbbbbbbbbbbaaadddd
dddaaabbbbbbeeeeeeeeeeebbbbbbaaaddd
ddaaabbbbbbeeeeeeeeeeeeebbbbbbaaadd
ddaabbbbbbeeeeeeeeeeeeeeebbbbbbaadd
ddaabbbbbeeeeeeeeeeeeeheeebbbbbaadd
ddaabbbbeeeeheiiiiiiieeeeeebbbbaadd
ddaabbbbeeeeeiieefeeiieeeeebbbbaadd
ddaabbbbeeeeeieoeeeoeieeeeebbbbaadd
ddaabbbbeeeeeieeeeeeeieeeeebbbbaadd
ddaabbbbeeeeeigeemeejieeeeebbbbaadd
ddaabbbbeeeeeieeeeeeeieeeeebbbbaadd
ddaabbbbeheeeiekeeeleiheeeebbbbaadd
ddaabbbbeeeeeiieeoeeiieeeeebbbbaadd
ddaabbbbeeeeeeiiiiiiieeeeeebbbbaadd
ddaabbbbbeeeeeeeeeeeeeeeeebbbbbaadd
ddaabbbbbbeeeeeeeeheeeeeebbbbbbaadd
ddaaabbbbbbeeeeeeeeeeeeebbbbbbaaadd
dddaaabbbbbbeeeeeneeeeebbbbbbaaaddd
ddddaaabbbbbbbbbbbbbbbbbbbbbaaadddd
dddddaaabbbbbbbbbbbbbbbbbbbaaaddddd
ddddddaaabbbbbbbbbbbbbbbbbaaadddddd
dddddddaaaaaaaaaapaaaaaaaaaaddddddd
ddddddddaaaaaaaaaaaaaaaaaaadddddddd
ddddddddddddddddddddddddddddddddddd
ddddddddddddddddddddddddddddddddddd
"}
